#################
#...............#
#.K.............#
#.......##......#
#......#..#.....#
#......#........R
#...............#
#.......#.......#
#...............#
#...............#
########D########
