########U########
#...............#
#.#####.........#
#.#####.........#
#.##............#
L...............R
#...............#
#...............#
#...............#
#...............#
########D########
