########U########
#...............#
#.#####.........#
#.#####.........#
#.#####.........#
L.###...........R
#...............#
#...............#
#...............#
#...............#
#################
