########U########
#...............#
#.#####.........#
#.#####.........#
#.#####.........#
L.#.............R
#...............#
#...............#
#...............#
#...............#
#################
