########U########
#...............#
#.#####.........#
#.#####.........#
#.####..........#
L...............#
#...............#
#...............#
#...............#
#...............#
########D########
