########U########
#...............#
#.#####.........#
#.#####.........#
#.#####.........#
L.####..........#
#...............#
#...........##.##
#...........#...#
#...........#...#
##############j##
