#################
#...............#
#.###...........#
#...............#
#...............#
L...............R
#...............#
#...............#
#...............#
#...............#
########D########
