#################
#...............#
#.####..........#
#...............#
#...............#
L...............#
#...............#
#...............#
#...............#
#...............#
########D########
