########U########
#...............#
#.#####.........#
#...............#
#...............#
#...............R
#...............#
#...............#
#...............#
#...............#
########D########
