########U########
#...............#
#.#####.........#
#.#.............#
#...............#
L...............R
#...............#
#...............#
#...............#
#...............#
########D########
