########U########
#...............#
#.#####.........#
#.###...........#
#...............#
L...............R
#...............#
#...............#
#...............#
#...............#
########D########
