########U########
#...............#
#.#####.........#
#.####..........#
#...............#
L...............#
#...............#
#...............#
#...............#
#...............#
########D########
